NO  ./texture/1.xpm  
SO  ./texture/2.xpm
WE  ./texture/3.xpm
WE  ./texture/4.xpm

F 58,66,11
C 8,6,1


1111111
10W0001
1000001
1000001
1111111
1   111111