NO  ./texture/1.xpm  
SO  ./texture/2.xpm
WE  ./texture/3.xpm
EA  ./texture/4.xpm

F 58,66,11
F 58,66,11
F 58,66,11
F 58,66,11
F 0,0,0

F 22,33,55

1111111
1111111
1111111
10W0001
1000001
1000001
1111111
1   111111