NO  ./texture/NO.xpm  
SO  ./texture/NO.xpm
WE  ./texture/NO.xpm
EA  ./texture/NO.xpm
C  10, 200, 25
F  0, 128, 0 

11111111111111111111
1N000100000000010001
10000101001000010101
10000101000000010101
10000001000000000101
10010001000001000101
10000101000000110001
10000100000000010001
10000101000000010101
10000001000000000101
10010001000001000101
11111111111111111111
