NO  ./xpms/walls/ressalhi1.xpm   
SO  ./xpms/walls/ressalhi2.xpm
WE  ./xpms/walls/ressalhi3.xpm
EA  ./xpms/walls/ressalhi4.xpm
C  0, 255, 25
F  0, 128, 0 

11111111111111111111
10000100000000010001
10000101000000010101
1000010100000N010101
10000001000000000101
10010001000001000101
10000100000000010001
10000101000000010101
10000101000000010101
10000001000000000101
10010001000001000101
11111111111111111111