NO  ./xpms/walls/ressalhi1.xpm   
SO  ./xpms/walls/ressalhi2.xpm
WE  ./xpms/walls/ressalhi3.xpm
EA  ./xpms/walls/ressalhi4.xpm
C  0, 255, 255
F  0, 128, 0 

1111111111111111111111111111111111111111111111
10E0000020000001000000200001000000000020000001
1000000010000001000000100001000000000010000001
1111111110000001000000100002000000000010000001
1111111110000002000000111111111111111111111111
1111111111111111000000000000000000000000000001
1100000000000001000000000000000000000000000001
1100000000000001000000111111111111111111111111
1111111111111211000000100001000000000010000001
1000000000010000000000100001000000000010000001
1000000000010000000000100001111121111110000001
1000000000020000000000200000000000000020000001
1000000000010000000000100000000000000010000001
1000000000010000000000100000000000000010000001
1000000000010000000000100000000000000010000001
1111111111111111111111111111111111111111111111