NO  ./xpms/walls/ressalhi1.xpm   
SO  ./xpms/walls/ressalhi2.xpm
WE  ./xpms/walls/ressalhi3.xpm
EA  ./xpms/walls/ressalhi4.xpm
C  0, 255, 25
F  0, 128, 0 

111111
100001
100001
100001
100001
100101
111111